J Clin Invest|J. Clin. Invest.
BioSocieties|Biosocieties
Nat Rev Drug Discov|Nat. Rev. Drug Discovery
Proteomics Clin Appl|Proteomics Clin. Appl.
Pharmacogenomics J|Pharmacogenomics J.
Journal of Molecular Graphics|J. Mol. Graph. Model.
J R Soc Interface|J. R. Soc. Interface
Journal of Molecular Biology|J. Mol. Biol.
J Comput Chem|J. Comput. Chem.
PNAS|Proc. Natl. Acad. Sci. U.S.A.
Protein Sci|Protein Sci.
Annu Rev Biophys Biomol Struct|Annu. Rev. Biophys. Biomol. Struct.
Acta Crystallogr. D Biol. Crystallogr.|Acta Crystallogr., Sect D: Biol. Crystallogr.
Chemical Physics|Chem. Phys.
Fold Des|Fold Des.
J Struct Func Genom|J. Struct. Func. Genom.
Catal. Sci. Technol.|Catal. Sci. Technol.
Biochem. J.|Biochem. J.
Biophys J|Biophys. J.
Protein Science|Prot. Sci.
J Phys Chem B|J. Phys. Chem. B
WIREs Comput Mol Sci|WIREs Comput. Mol. Sci.
Nat Struct Mol Biol|Nat. Struct. Mol. Biol.
EMBO Rep|EMBO Rep.
International Journal of High Performance Computing Applications|Int. J. High Perform. Comput. Appl.
J Comput Aided Mol Des|J. Comput. Aided Mol. Des.
PLoS Comput Biol|PLoS Comput. Biol.
Journal of Chemical Physics|J. Chem. Phys.
Journal of Magnetic Resonance|J. Magn. Reson.
Journal of Computational and Theoretical Nanoscience|J. Comput. Theor. Nanosci.
Phys. Rev.|Phys. Rev. A
Computers \& Chemistry|Comput. Chem.
BMC Bioinformatics|BMC Bioinformatics
Stat Comput|Stat. Comput.
Int. J. Quantum Chem.|Int. J. Quantum Chem
J Chem Inf Model|J. Chem. Inf. Model.
Nat Commun|Nat. Commun.
Biophysical Chemistry|Biophys. Chem.
Biochimica et Biophysica Acta (BBA) - General Subjects|Biochim. Biophys. Acta, Gen. Subj
J Chem Theory Comput|J. Chem. Theory Comput.
Angewandte Chemie International Edition|Angew. Chem. Int. Ed.
J Struct Funct Genomics|J. Struct. Funct. Genomics
Biophysical Journal|Biophys. J.
Molecular Cell|Mol. Cell
Journal of Molecular Graphics and Modelling|J. Mol. Graphics Modell.
PLOS ONE|PLoS ONE
Mol Biol|Mol. Biol.
Phys Rev E Stat Nonlin Soft Matter Phys|Phys. Rev. E: Stat., Nonlinear, Soft Matter Phys.
Nat Chem Biol|Nat. Chem. Biol.
Trends in Biochemical Sciences|Trends Biochem. Sci
Bioorganic \& Medicinal Chemistry|Bioorg. Med. Chem.
Computer Physics Communications|Comp. Phys. Comm.
Acta Crystallographica Section A Foundations of Crystallography|Acta Crystallogr., Sect. A: Found. Crystallogr.
Journal of Health Economics|J. Health. Econ.
Current Topics in Medicinal Chemistry|Curr. Top. Med. Chem.
Journal of Chemical Information and Modeling|J. Chem. Inf. Model.
BMC Structural Biology|BMC Struct. Biol.
Journal of Medicinal Chemistry|J. Med. Chem.
Proteins: Structure, Function, and Bioinformatics|Proteins: Struct., Funct., Bioinf.
RSC Biomolecular Sciences|RSC Biomol. Sci.
Current Opinion in Structural Biology|Curr. Opin. Struct. Biol.
Dtsch. Chem. Ges|Dtsch. Chem. Ges.
Communications of the ACM|Commun. ACM
Journal of Computational Chemistry|J. Comput. Chem.
Nucleic Acids Research|Nuc. Acids Res.
The Journal of Physical Chemistry B|J. Phys. Chem. B
The Journal of Chemical Physics|J. Chem. Phys.
Bulletin of the Korean Chemical Society|Bull. Korean Chem. Soc.
Methods|Methods
Annual Review of Biophysics|Annu. Rev. Biophys.
Concurr. Comput. : Pract. Exper.|Concurr. Comput. : Pract. Exper.
Electronic Proceedings in Theoretical Computer Science|Electron. Proc. Theor. Comput. Sci.
Proceedings of the National Academy of Sciences|Proc. Natl. Acad. Sci. USA
Journal of the Optical Society of America A|J. Opt. Soc. Am. A
Data Mining and Knowledge Discovery|Data Min. Knowl. Discov.
Acta Crystallographica Section A|Acta Crystallogr., A, Found. Crystallogr.
IEEE Transactions on Pattern Analysis and Machine Intelligence|IEEE Trans. Pattern Anal. Mach. Intell.
Journal of Information and Computational Science|J. Info. Comput. Sci.
Comp. Phys. Comm|Comput. Phys. Commun.
J. Stat. Soft.|J. Stat. Soft.
IEEE Transactions on Information Theory|IEEE Trans. Inf. Theory
Cybernetics and Systems|Cybernet. Syst.
Communications in Statistics|Commun. Stat.
Journal of Computational and Applied Mathematics|J. Comput. Appl. Math.
IEEE Transactions on Computer-Aided Design of Integrated Circuits and Systems|IEEE Trans. Comput.-Aided Design Integr. Circuits Syst
New England Journal of Medicine|N. Engl. J. Med.
Physiological Reviews|Physiol. Rev.
ACS Catal.|ACS Catal.
J. Phys. Chem. Lett.|J. Phys. Chem. Lett.
Sci. China Chem.|Sci. China Chem.
Neoplasia|Neoplasia
